

        **                ***   **             ***           *        **   
        **               *    ****        ********           **  ** * **   
        **             *    ****           *******           *** ***  **** 
       ***             ********            *****            ******   ******
       ****             **  ***           *     **        *        **** ** 
       ********            *  ******     * *  * **        **    ****** **  
       *********           * ***  **   **   **  ******     ** ****    ***  
       ******             * * *** ***       ******  ***    ***** ** ****** 
     ******               *  *******   *  **** ***  ****   *  *  ***** **  
    ******               * ****  **    ***  ** **   ***    *    ** *  **   
 ********               **    * ***    **   *  **  ***         **  *  **** 
   *****                *   *****       *   *  *   ***       * *  ** ******
    ****               *  *****         *   * **** **        ***  ***** ***
     **   *            * * *    ***      ************       *  * ***  ***  
     *********        *    * ******       *       **       **  ***   *  *  
    ***    *****     **    ***   **               *        **  **       *  
 * ***       ****    **    **    **                                **  **  
*****         ***   **     *******                                   ***   
                   *           ***                            
                               *                                     


